......._______........
.......__o_<__........
......_____<__........
......_____<__........
.....____.____........
....._o__.____........
....____..____........
...._o__..__S_........
...____...............
...____...............
..____________________
..o_>______o__________
.___>______________o__
___________________vv_
..................____
..................____
EE____________________
EE_____o___________<__
EE___________o_____<__
EE____________________
@20@S for Sol@